....................
....................
....................
....................
....................
.............1......
....................
....................
....................
....................
....................
.P................X.
####################
####################
####################
